XXXXXXXXXXXXXXXXXXXXX
X                   X
X                   X
X                   X
X                   X
X             R     X
X                   X
X                 R X
X                   X
X      P            X
X     XXXB          X
X                   X
X    R              X
X              X    X
X              X    X
X              X    X                 X
X              X    XXXXXXXXXXXXX     X
X  R           X                      X
X              X                      X    
X              XXXXXXXXXXXXXXXXXXXXXXXX
X                   X
X                   X
X                   X
X                   X
XXXXXXXXXXXXXXXXXXXXX