XXXXXXXXXXXXXXXXXXXXX
X                   X
X         R         XXXXXXXX
X                   X      X
X                   X      X
X                   X  XXXXXXXXXXXXXXXXXXXXXXXXXXXXXXXXXXXXXXXXXXXXXXXX
X                   X                                                 X
X                   X                                                 X
X                   X                                                 X
X      P            XXXXXXXXXXXXXXXXXXX                               X
X     XXXB                                                            X
X                                                                     X
XXXXXXXXXXXXXXXXXXXXXXXXXXXXXXXXXXXXXXXXXXXXXXXXX                     X
                                          X                           X
                                          XXXXXXXXXXXXXXXXXXXXXXXXXXXXX
